23
    ##
 ### P#
#  S  #
# S S#
#  ####
# O  O #
# O O  G#
#########